NO ./textures/north_oversize.xpm
SO ./textures/south.xpm
WE ./textures/west_undersize.xpm
EA ./textures/east.xpm

F 164,169,20
C 153,204,255

1111
1001
10N1
1111
