NO 	textures/nnn_letter.xpm                      
SO textures/sss_letter.xpm
WE textures/www_letter.xpm
F 153,76,210
EA 	textures/eee_letter.xpm
C 	231,21,243




111111111
11110000011
111100111
100101             111111111
1010N1             111110001
100111             111111111
11111111
