
NO textures/nnn_letter.xpm
SO textures/sss_letter.xpm
WE textures/www_letter.xpm
F 0,0,25
EA textures/eee_letter.xpm
C 225,30,92

111111
1000S1
100001
111011
111111
