NO textures2/wall.xpm                      

C 85,178,251







SO textures2/water.xpm
WE textures2/wood.xpm

F 100,0,0

EA textures2/grass.xpm		







1111    11111111111     11111111111111       111
1001    10000000001   110100000N100001       101
1001    10110000011     10000001000001       111
1001    100100000001111100000000111111
100111111011000001110000000000001
100000000011000001110111111111111          111111111
11110111111111011100000000001              100000001
11110111111111011101010010001              1111111111
110000001101110111000000100011
100000000111 110000001100001
10000000000010001010100100001
110000011100000111110111100011
11110111 1110101 101111010001
11111111 1111111 111111111111
