WE                            textures2/wood.xpm
NO      textures2/wall.xpm



SO textures2/water.xpm

F   69,222,199

EA textures2/grass.xpm



C 235,198,52


1111
1001
N
1111
1111







