NO textures/verde.xpm                      
SO textures/vermelho.xpm
WE textures/amarelo.xpm
F 153,36,222
EA textures/preto.xpm
C 30,31,132


1111        1111
1S01     1110011
1001        11
1001      1111111
1111
