NO 	textures/verde.xpm                      
SO textures/vermelho.xpm
WE textures/amarelo.xpm
F 153,76,210
EA 	textures/preto.xpm
C 	231,21,243


1111        1111
10N11     1110011
1001      1111111
1111
