NO 	textures/nnn_letter.xpm                      
SO textures/sss_letter.xpm
WE textures/www_letter.xpm
F 153,76,210
EA 	textures/eee_letter.xpm
C 	231,21,243






111111111
100101
101001
1001P1
11111111
