NO textures/verde.xpm                      
SO textures/vermelho.xpm
WE textures/amarelo.xpm
F 153,36,222
EA textures/preto.xpm
C 23,231,32


1111        1111
1N01     1110011
1101        11
1011      1111111
1111
