NO textures/verde.xpm                      
SO textures/vermelho.xpm
WE textures/amarelo.xpm
F 153,36,222
EA textures/preto.xpm
C 23,231,32


1111        1111
10N11     1110011
10S1      1111111
1111
