11111111111111111111
10001100011000110001
10001100011000110001
10001100011000110001
100P1100011000110001
11111111111111111111
