NO 				textures/verde.xpm                      
SO         	   	   textures/vermelho.xpm
WE 	 	 		textures/amarelo_riscas.xpm  
C 30,31,132
EA textures/preto.xpm






F 15,13,222


                 1
1111111111111111111111111111111111111111
1111110000000000000E0000111111000111111                       
111111111111110000000000000000000000011111111111                 
1111111111111111111111111111111111111111111111111111111111111
1111111111111111111111111111111111111111111111111111111111111111

        
1111111111111111111111111111111111111111111111111
