NO 				textures/verde.xpm                      
SO         	   	   textures/vermelho.xpm
WE 	 			textures/amarelo_riscas.xpm  
C 30,31,132
EA textures/preto.xpm






F 15,13,222


1111111111111111111111111111111111111111
11111100000000000E1000111111000111111                       
11111111111110000001000000000000000011111111111                 
1111111111111111111111111111111111111111111111111111111111111
1111111111111111111111111111111111111111111111111111111111111111

        
1111111111111111111111111111111111111111111111111
111000000000000000000000000000000000001111111111
111111111111111111111111111111111111111111












